####################
#P........#........#
#.####D##.###.####.#
#.#.....#...#....#.#
#.#####.###.####.#.#
#.....#...#......#.#
#.###.###.########.#
#...#..............#
###.##############.#
#...#.......#....#.#
#.#######.#.####.#.#
#.......#.#....#.#.#
#.#####.#####.##.#.#
#.#...#..........#.#
#.#.###.##########.#
#.#.#............#.#
#.###.##########.#.#
#.....#........O...#
#########D##########