######################
#P........#...K......#
#####L###.###.######.#
#.#.....#...#......#.#
#.#####.###.######.#.#
#.....#...#........#.#
#.###.###.##########.#
#...#................#
###.################.#
#...#.........#....#.#
#.#######.#.####.#.#.#
#.......#.#....#.#.#.#
#.#####.#####.##.#.#.#
#.#...#............#.#
#.#.###.############.#
#.#.#..............#.#
#.###.############.#.#
#.....#..........O...#
######################