####################
#P.................#
#.......#..........#
#.###.###.###.####.#
#.#.....#.#......#.#
#.#.###.#.###.##.#.#
#.#.#...#........#.#
#.#.###.##########.#
#..................#
#.#.##############.#
#.#.......#......#.#
#.#######.#.####.#.#
#.......#.#....#.#.#
#.#####.#####.##.#.#
#.#...#..........#.#
#.#.###.##########.#
#.#..............#.#
#.##############.#.#
#...............O..#
####################